ДЕВОЧКА	N
CLF:ЧЕЛОВЕК:УПАСТЬ	V
ДОМ	N
СТРОИТЬ	V
МАЛЬЧИК	N
ЧИТАТЬ	V
МАМА	N
УСТАЛЫЙ	V
ОКНО	N
РАЗБИТЫЙ	V
ПАПА	N
БЕЖАТЬ	V
РЕБЕНОК	N
ТАНЦЕВАТЬ	V
СОБАКА	N
ЕСТЬ	V
ТЕЛЕВИЗОР	N
СЛОМАННЫЙ	V
УЧИТЕЛЬ	N
СМЕЯТЬСЯ	V
УПАСТЬ	V
ГДЕ	Q
КОГДА	Q
ЧТО	Q
ПОЧЕМУ	Q
КУДА	Q
